,tournament,fullname,Count_Win,Count_Lose,total_play,perc_win
287,US Open,Pete Sampras,19,2,21,90.48
276,US Open,Novak Djokovic,72,11,83,86.75
316,US Open,Roger Federer,89,14,103,86.41
299,US Open,Rafael Nadal,64,11,75,85.33
27,US Open,Andre Agassi,28,7,35,80.0
203,US Open,Juan Martin Del Potro,35,9,44,79.55
40,US Open,Andy Murray,45,12,57,78.95
242,US Open,Marin Cilic,36,10,46,78.25999999999999
41,US Open,Andy Roddick,43,12,55,78.18
224,US Open,Lleyton Hewitt,45,13,58,77.59
